{
    "x":-96,
    "y":-96,
    "layers": ["555555555555555555555555
                511111151111111111111115
                511111151111111111111115
                511111151111555555555515
                511111151111511111115115
                511155551111111111155115
                511111111111111111151115
                511111111111511111151115
                511111111111511111551115
                511111111111555555511115
                511111111111111111111115
                511111111111111111111115
                555555555555555555555555",

               "000000000000000000000000
                099999000000000000000000
                099999000000000000000000
                099999000000000000000000
                099999000000066666660000
                066600000000066666600000
                000000000000066666600000
                000000000000066666600000
                000000000000066666000000
                000044444000000000000000
                000044444000000000000000
                000044444000000000000000
                000000000000000000000000"]
}
